{
  "tiles": [
    [19, 19, 19, 19, 19, 19, 19, 2, 2, 19, 19, 19, 19, 19, 19, 19],
    [19, 19, 19, 19, 10, 19, 20, 2, 2, 19, 19, 19, 19, 19, 19, 19],
    [19, 19, 19, 20, 2, 2, 2, 2, 2, 19, 19, 19, 19, 19, 19, 19],
    [19, 19, 20, 2, 2, 2, 2, 2, 2, 19, 19, 19, 19, 19, 19, 19],
    [19, 20, 2, 2, 2, 2, 2, 2, 2, 18, 19, 19, 19, 19, 19, 19],
    [2, 2, 2, 2, 2, 2, 2, 2, 2, 2, 2, 2, 2, 2, 2, 2],
    [13, 14, 2, 2, 2, 2, 2, 2, 2, 2, 2, 2, 2, 2, 13, 13],
    [19, 19, 2, 2, 2, 2, 2, 2, 2, 2, 2, 2, 2, 2, 19, 19],
    [19, 19, 2, 2, 2, 2, 2, 2, 2, 2, 2, 2, 2, 2, 19, 19],
    [19, 19, 13, 13, 13, 13, 13, 13, 13, 13, 13, 13, 13, 13, 19, 19],
    [19, 19, 19, 19, 19, 19, 19, 19, 19, 19, 19, 19, 19, 19, 19, 19]
  ],
  "color": 1,
  "properties": {
    "solid": [12, 13, 14, 18, 19, 20]
  }
}
